1 1
9 10
###########
# #########
#  ########
##  #######
###  ######
####  #####
#####  ####
######  ###
#######  ##
########  #
######### #
###########