1 1
7 16
#########
#       #
#       #
#       #
#       #
#       #
#       #
#       #
#       #
#       #
#       #
#       #
#       #
#       #
#       #
#       #
#       #
#########