1 3
3 1
  #######################
  #                     #
####################### #
#                       #
#########################