1 15
9 1
        ###########      
        #         #      
      ########### #      
      #           #      
      # #############    
      #             #    
    ############### #    
    #               #    
    # #################  
    #                 #  
  ################### #  
  #                   #  
  # #####################
  #                     #
####################### #
#                       #
#########################