1 7
5 1
    ##########  
    #        #  
  ########## #  
  #          #  
  # ############
  #            #
############## #
#              #
################